        1111111111111111111111111
        1000000000110000000000001
        1011000001110000000000001
        1001000000000000000100001
111111111011000001110000000000001
100000000011000001110111111111101
11110111111111011100000010001
11110111111111011101010010001
11000000110101011100000010001
10000000000000001100000010001
10000000000000001101010010001
11000001110101011111011110N0111
11110111 1110101 101111010001
11111111 1111111 111111111111
