NO ./xpm/NO.xpm
SO ./xpm/SO.xpm
WE ./xpm/WE.xpm
EA ./xpm/EA.xpm

F 122,214,53
C 53,151,214

       1111111111111111111111111
        1000000000110000000000001
        1011000001110000000000001
        1001000000000000000000001
111111111011000001110000000000001
100000000011000001110111111111111
11110111111111011100000010001
111101111111110111010100100001
11000000110101011100000000S01
10000000000000001100000010001
10000000000000001101010010001
110000011101010111110111100111
11110111 1110101 101111010001
111111111111111 111111111111
